NO ./textures/grass.xpm
SO ./textures/stone.xpm

                           WE                           ./textures/tilledsoil.xpm

EA ./textures/water.xpm

F 100,125,125
C 10,125,125

        1111111111111111111111111
        10000000000000000000000W1
        1111111111111111111111111
