NO ./textures/grass.xpm
SO ./textures/stone.xpm
WE ./textures/tilledsoil.xpm
EA ./textures/water.xpm

F 100,125,125
C 10,125,125

111111111111111111111111111111111
100000000000000000000000000000001
100000000000000000000000000000001
1000000000000000000N100000000001
100000000000000000000000000000001
111111111111111111111111111111111